73 365 2
1 3 2
24 24 24 24 29 27 27 30 24 24 29 27 27 30 24 24 29 27 27 30 
29 27 27 27 28 40 40 23 24 24 25 40 40 23 24 24 25 40 40 23 
25 -1 -1 -1 -1 -1 -1 23 24 24 25 -1 -1 23 24 24 25 -1 -1 23 
25 -1 -1 -1 -1 -1 -1 13 27 27 28 -1 -1 13 27 27 28 -1 -1 23 
31 38 07 07 05 -1 -1 -1 -1 -1 -1 -1 -1 -1 -1 -1 -1 -1 -1 23 
24 24 24 24 25 -1 -1 -1 -1 -1 -1 -1 -1 -1 -1 -1 -1 -1 -1 23 
00 00 00 24 25 42 42 04 07 07 07 07 05 -1 -1 -1 -1 -1 -1 23 
24 24 24 24 31 21 21 32 24 24 24 24 25 -1 -1 -1 -1 -1 -1 23 
29 27 27 27 27 27 27 27 27 27 27 27 28 -1 -1 -1 -1 -1 04 32 
25 -1 -1 -1 -1 -1 -1 -1 -1 -1 -1 -1 -1 -1 -1 -1 -1 -1 23 24 
25 -1 -1 -1 -1 -1 -1 -1 -1 -1 -1 -1 -1 -1 -1 -1 04 07 32 24 
25 -1 -1 -1 04 07 07 07 07 07 07 07 07 07 07 07 32 24 24 24 
25 -1 -1 -1 23 24 24 24 24 24 24 24 24 24 24 24 24 24 00 00 
31 07 07 07 32 24 00 00 00 00 00 00 00 00 00 00 00 00 00 00 
24 24 24 24 24 24 00 00 00 00 00 00 00 00 00 00 00 00 00 00 
0
3