88 14 2
2 10 0
24 25 -1 -1 -1 -1 -1 -1 -1 -1 -1 -1 -1 -1 -1 -1 -1 -1 -1 -1 
24 25 -1 -1 -1 -1 -1 -1 -1 -1 -1 -1 -1 -1 -1 -1 -1 -1 -1 -1 
24 31 07 05 -1 -1 -1  -1 -1 -1 -1 -1 -1 -1 -1 -1 -1 -1 -1 -1 
27 27 27 15 -1 -1 -1 -1 -1 -1 -1 -1 41 04 05 -1 -1 -1 -1 -1 
-1 -1 -1 -1 -1 -1 -1 -1 -1 -1 -1 -1 41 13 15 -1 -1 -1 -1 -1 
-1 -1 -1 -1 -1 -1 -1 -1 04 05 -1 -1 -1 40 40 -1 -1 -1 -1 -1 
-1 -1 -1 -1 -1 -1 -1 -1 13 28 -1 -1 -1 -1 -1 -1 -1 -1 -1 -1 
42 42 42 42 42 -1 -1 -1 -1 -1 -1 -1 -1 -1 -1 42 42 -1 -1 -1 
21 21 21 21 10 42 42 42 42 42 42 42 42 42 42 08 10 -1 -1 08 
29 27 36 30 31 21 21 21 21 21 21 21 21 21 21 32 25 -1 -1 23 
25 -1 -1 23 29 27 27 27 27 27 27 27 27 27 27 27 28 -1 -1 23 
25 -1 -1 13 28 -1 -1 -1 -1 -1 -1 -1 -1 -1 -1 -1 -1 -1 -1 23 
25 -1 -1 -1 -1 -1 -1 -1 -1 -1 -1 -1 -1 -1 -1 -1 -1 -1 -1 23 
25 -1 -1 -1 -1 -1 -1 -1 -1 -1 -1 -1 -1 04 05 -1 -1 -1 -1 23 
31 07 07 07 07 07 07 05 -1 -1 04 07 07 32 31 07 05 -1 -1 32 
6
149 140 1
67 173 1
95 137 0
70 151 1
577 153 0