62 101 2
18 4 2
24 24 24 24 24 24 24 29 27 27 27 27 30 24 24 24 24 24 24 24 
29 27 27 27 27 27 27 28 40 40 40 40 13 27 27 27 27 27 27 30 
25 -1 -1 -1 -1 -1 -1 -1 -1 -1 -1 -1 -1 -1 -1 -1 -1 -1 -1 23 
25 -1 -1 -1 -1 -1 -1 -1 -1 -1 -1 -1 -1 -1 -1 -1 -1 -1 -1 23 
25 -1 -1 -1 -1 -1 -1 -1 -1 -1 -1 -1 -1 -1 -1 -1 -1 -1 -1 23 
31 07 07 05 42 42 04 05 -1 -1 -1 -1 04 05 42 42 04 07 38 32 
24 24 24 31 21 21 32 25 42 -1 -1 -1 23 31 21 21 32 24 24 24 
00 00 24 24 24 24 24 31 22 43 -1 -1 23 24 24 24 24 24 00 00 
00 00 00 00 00 00 24 29 28 43 -1 -1 23 24 00 00 00 00 00 00 
00 00 00 00 00 00 24 25 40 -1 -1 -1 23 24 00 00 00 00 00 00 
00 00 00 00 00 00 24 25 -1 -1 -1 -1 23 24 00 00 00 00 00 00 
00 00 00 00 00 00 24 25 -1 -1 -1 42 23 24 00 00 00 00 00 00 
00 00 00 00 00 00 24 25 -1 -1 41 08 32 24 00 00 00 00 00 00 
00 00 00 00 00 00 24 25 -1 -1 41 23 24 24 00 00 00 00 00 00 
00 00 00 00 00 00 24 31 07 07 07 32 24 00 00 00 00 00 00 00 
0