50 380 2
18 12  2
00 00 00 00 24 29 27 27 27 27 27 27 27 27 30 24 00 00 00 00 
00 00 00 00 24 25 43 -1 -1 -1 -1 -1 -1 41 23 24 00 00 00 00 
24 24 24 24 24 25 43 -1 -1 -1 -1 -1 -1 41 23 24 24 24 24 24 
29 27 27 30 24 25 43 -1 -1 -1 -1 -1 -1 41 23 24 29 27 27 30 
25 -1 -1 23 24 31 22 -1 -1 04 05 -1 -1 08 32 24 25 -1 -1 23 
25 -1 -1 13 27 27 28 -1 -1 23 25 -1 -1 13 27 27 28 -1 -1 23 
25 -1 -1 -1 -1 -1 -1 -1 -1 23 25 -1 -1 -1 -1 -1 -1 -1 -1 23 
25 -1 -1 -1 -1 -1 -1 -1 -1 23 25 -1 -1 -1 -1 -1 -1 -1 -1 23 
25 -1 -1 -1 -1 04 07 07 07 32 31 07 07 07 05 -1 -1 -1 -1 23 
25 -1 -1 -1 -1 23 24 24 24 24 24 24 24 24 25 -1 -1 -1 -1 23 
25 -1 -1 -1 -1 23 24 00 00 00 00 00 00 24 25 -1 -1 -1 -1 23 
25 -1 -1 -1 -1 23 24 00 00 00 00 00 00 24 25 -1 -1 -1 -1 23 
25 -1 -1 -1 -1 23 24 00 00 00 00 00 00 24 25 -1 -1 -1 -1 23 
31 07 07 07 07 32 24 00 00 00 00 00 00 24 31 07 07 07 38 32 
24 24 24 24 24 24 24 00 00 00 00 00 00 24 24 24 24 24 24 24 
0