120 314 2
15 9 0
24 24 24 24 24 24 24 24 24 24 24 24 24 00 00 00 00 00 00 00 
24 29 27 27 27 30 24 29 27 27 27 30 24 00 00 00 00 00 00 00 
24 25 40 40 40 23 24 25 -1 -1 -1 23 24 00 00 00 00 00 00 00 
24 25 -1 -1 -1 13 27 28 -1 -1 -1 23 24 00 00 00 00 00 00 00 
24 25 -1 -1 -1 40 40 40 -1 -1 -1 23 24 00 00 00 00 00 00 00 
24 25 -1 -1 -1 -1 -1 -1 -1 -1 -1 23 24 24 24 00 00 00 00 00 
24 25 -1 -1 -1 42 42 42 -1 -1 -1 13 27 30 24 00 00 00 00 00 
24 25 -1 -1 -1 04 07 05 -1 -1 -1 -1 41 23 24 24 24 24 24 24 
24 25 -1 -1 -1 23 24 25 -1 -1 -1 -1 41 23 29 36 27 27 30 24 
24 25 -1 -1 -1 23 24 25 -1 -1 -1 08 21 32 25 -1 -1 41 23 24 
24 25 -1 -1 -1 23 24 25 -1 -1 -1 13 27 27 28 -1 -1 41 23 24 
24 25 -1 -1 -1 23 24 25 -1 -1 -1 -1 -1 -1 -1 -1 -1 41 23 24 
24 31 07 07 07 32 24 25 -1 -1 -1 -1 -1 -1 -1 -1 -1 41 23 24 
24 24 24 24 24 24 24 31 07 07 07 07 07 07 07 07 07 07 32 24 
00 00 00 00 00 00 24 24 24 24 24 24 24 24 24 24 24 24 24 24 
3
112 157 0
499 381 0
412 366 0