120 370 2
17 5 2
00 00 00 00 00 00 00 00 00 00 24 24 24 24 24 24 24 00 00 00 
00 00 00 00 00 00 00 00 00 00 24 29 27 27 27 30 24 24 24 24 
00 00 00 00 00 00 00 00 00 00 24 25 40 40 40 13 27 27 30 24 
00 00 00 00 00 24 24 24 24 24 24 25 -1 -1 -1 -1 -1 -1 23 24 
24 24 24 24 24 24 29 27 27 27 30 25 -1 -1 -1 -1 -1 -1 23 24 
24 29 27 27 27 27 28 40 40 40 23 25 -1 -1 -1 -1 -1 -1 23 24 
24 25 -1 -1 -1 -1 -1 -1 -1 -1 13 28 -1 -1 -1 04 07 38 32 24 
24 25 -1 -1 -1 -1 -1 -1 -1 -1 -1 -1 -1 -1 -1 23 24 24 24 24 
24 25 -1 -1 -1 -1 -1 -1 -1 -1 -1 -1 -1 -1 -1 23 24 00 00 00 
24 25 -1 -1 -1 04 07 05 -1 -1 -1 -1 -1 -1 -1 23 24 00 00 00 
24 25 -1 -1 -1 23 24 25 -1 -1 -1 -1 -1 -1 -1 23 24 00 00 00 
24 25 -1 -1 -1 23 24 31 07 07 07 07 07 07 07 32 24 00 00 00 
24 25 -1 -1 -1 23 24 24 24 24 24 24 24 24 24 24 24 00 00 00 
24 31 07 07 07 32 24 00 00 00 00 00 00 00 00 00 00 00 00 00 
24 24 24 24 24 24 24 00 00 00 00 00 00 00 00 00 00 00 00 00 
0
3
0 2 5 1 0 2
1 6 6 1 0 2
0 14 8 0 0 2